111111111111111
100CEP000000001
