111111
1C1001
1010E1
100111
1P0001
111111
