111111
1C1001
1110C1
111011
1P0E01
111111
