111111
1C1001
1110E1
111111
1P0001
111111
